##############
#S...........#
#............#
#............#
#...........G#
##############