##############
#S...........#
#....D.......#
#............#
#...........G#
##############