###############################
#S...........................##
#.#.#######..#..#####.#######.#
#.#.#.....#..#..#...#.#.....#.#
#...#.#...#..#..#.#...#.#...#.#
#####.#.#.#..##.#.#####.#.#.###
#...#:#.#...........#...#.#...#
#.#.###.#.#.#####.#.###.#.###.#
#.#...#...#.....#.#...#...#...#
#.###.#######.###.###.#######.#
#.#...#.....#...#...#.#.......#
#.#.#.#####.#.#.###.#.#.#######
#...#...#...#.#...#..........G#
###############################
