###############################
#S...........................##
#.#.#######..#..#####.#######.#
#.#.#.....#..#..#...#.#.....#.#
#...#.#...#..#..#.#...#.#...#.#
#####.#.#.#####.#.#####.#.#.###
#...#.#.#...#...#...#...#.#...#
#.#.###.#.#.#.###.#.###.#.###.#
#.#...#...#.....#.#...#...#...#
#.###.#######.###.###.#######.#
#.#...#.........#...#.#.......#
#.#.#.#####.#...###.#.#.#######
#...#...#...#.#..............G#
###############################
