##########
#S.......#
#..:*:...#
#.....G..#
##########