##########
#S.......#
#..***...#
#.....G..#
##########